###################
#........#........#
#.##.###.#.###.##.#
#.................#
#.##.#.#####.#.##.#
#....#...#...#....#
####.### # ###.####
   #.#   H   #.#   
####.# ## ## #.####
    .  #HHH#  .    
####.# ##### #.####
   #.#       #.#   
####.# ##### #.####
#........#........#
#.##.###.#.###.##.#
#..#.....C.....#..#
##.#.#.#####.#.#.##
#....#...#...#....#
#.######.#.######.#
#.................#
###################