###################
#                 #
#                 #
#                 #
# ############### #
#        .        #
###################