###################
#                 #
#                 #
#                 #
#     ########### #
#        .        #
###################