###################
#                 #
#     #############
#                 #
# ############### #
# #      .        #
###################