###################
#    #            #
#    #######      #
#                 #
########  #########
#               . #
###################